"filename", "language", "CMake", "CMake Cache", "comment", "blank", "total"
"/root/wqdServer/build/CMakeCache.txt", "CMake Cache", 0, 434, 0, 85, 519
"/root/wqdServer/build/CMakeFiles/3.14.5/CMakeCCompiler.cmake", "CMake", 59, 0, 0, 17, 76
"/root/wqdServer/build/CMakeFiles/3.14.5/CMakeCXXCompiler.cmake", "CMake", 62, 0, 0, 17, 79
"/root/wqdServer/build/CMakeFiles/3.14.5/CMakeSystem.cmake", "CMake", 10, 0, 0, 6, 16
"/root/wqdServer/build/CMakeFiles/CMakeDirectoryInformation.cmake", "CMake", 12, 0, 0, 5, 17
"/root/wqdServer/build/CMakeFiles/Makefile.cmake", "CMake", 61, 0, 0, 6, 67
"/root/wqdServer/build/CMakeFiles/bin_wqd.dir/DependInfo.cmake", "CMake", 20, 0, 0, 4, 24
"/root/wqdServer/build/CMakeFiles/bin_wqd.dir/cmake_clean.cmake", "CMake", 9, 0, 0, 2, 11
"/root/wqdServer/build/CMakeFiles/my_http_server.dir/DependInfo.cmake", "CMake", 20, 0, 0, 4, 24
"/root/wqdServer/build/CMakeFiles/my_http_server.dir/cmake_clean.cmake", "CMake", 9, 0, 0, 2, 11
"/root/wqdServer/build/CMakeFiles/orm.dir/DependInfo.cmake", "CMake", 24, 0, 0, 4, 28
"/root/wqdServer/build/CMakeFiles/orm.dir/cmake_clean.cmake", "CMake", 13, 0, 0, 2, 15
"/root/wqdServer/build/CMakeFiles/wqd.dir/DependInfo.cmake", "CMake", 83, 0, 0, 5, 88
"/root/wqdServer/build/CMakeFiles/wqd.dir/cmake_clean.cmake", "CMake", 73, 0, 0, 2, 75
"/root/wqdServer/build/CMakeFiles/test_array.dir/DependInfo.cmake", "CMake", 20, 0, 0, 4, 24
"/root/wqdServer/build/CMakeFiles/test_array.dir/cmake_clean.cmake", "CMake", 9, 0, 0, 2, 11
"/root/wqdServer/build/CMakeFiles/test_bitmap.dir/DependInfo.cmake", "CMake", 24, 0, 0, 5, 29
"/root/wqdServer/build/CMakeFiles/test_bitmap.dir/cmake_clean.cmake", "CMake", 9, 0, 0, 2, 11
"/root/wqdServer/build/CMakeFiles/test_crypto.dir/DependInfo.cmake", "CMake", 20, 0, 0, 4, 24
"/root/wqdServer/build/CMakeFiles/test_crypto.dir/cmake_clean.cmake", "CMake", 9, 0, 0, 2, 11
"/root/wqdServer/build/CMakeFiles/test_dict.dir/DependInfo.cmake", "CMake", 20, 0, 0, 4, 24
"/root/wqdServer/build/CMakeFiles/test_dict.dir/cmake_clean.cmake", "CMake", 9, 0, 0, 2, 11
"/root/wqdServer/build/CMakeFiles/test_email.dir/DependInfo.cmake", "CMake", 24, 0, 0, 5, 29
"/root/wqdServer/build/CMakeFiles/test_email.dir/cmake_clean.cmake", "CMake", 9, 0, 0, 2, 11
"/root/wqdServer/build/CMakeFiles/test_hashmap.dir/DependInfo.cmake", "CMake", 20, 0, 0, 4, 24
"/root/wqdServer/build/CMakeFiles/test_hashmap.dir/cmake_clean.cmake", "CMake", 9, 0, 0, 2, 11
"/root/wqdServer/build/CMakeFiles/test_hashmultimap.dir/DependInfo.cmake", "CMake", 20, 0, 0, 4, 24
"/root/wqdServer/build/CMakeFiles/test_hashmultimap.dir/cmake_clean.cmake", "CMake", 9, 0, 0, 2, 11
"/root/wqdServer/build/CMakeFiles/test_http_server.dir/DependInfo.cmake", "CMake", 20, 0, 0, 4, 24
"/root/wqdServer/build/CMakeFiles/test_http_server.dir/cmake_clean.cmake", "CMake", 9, 0, 0, 2, 11
"/root/wqdServer/build/CMakeFiles/test_module.dir/DependInfo.cmake", "CMake", 23, 0, 0, 5, 28
"/root/wqdServer/build/CMakeFiles/test_module.dir/cmake_clean.cmake", "CMake", 9, 0, 0, 2, 11
"/root/wqdServer/build/CMakeFiles/test_mysql.dir/DependInfo.cmake", "CMake", 24, 0, 0, 5, 29
"/root/wqdServer/build/CMakeFiles/test_mysql.dir/cmake_clean.cmake", "CMake", 9, 0, 0, 2, 11
"/root/wqdServer/build/CMakeFiles/test_nameserver.dir/DependInfo.cmake", "CMake", 24, 0, 0, 5, 29
"/root/wqdServer/build/CMakeFiles/test_nameserver.dir/cmake_clean.cmake", "CMake", 9, 0, 0, 2, 11
"/root/wqdServer/build/CMakeFiles/test_rock.dir/DependInfo.cmake", "CMake", 24, 0, 0, 5, 29
"/root/wqdServer/build/CMakeFiles/test_rock.dir/cmake_clean.cmake", "CMake", 9, 0, 0, 2, 11
"/root/wqdServer/build/CMakeFiles/test_service_discovery.dir/DependInfo.cmake", "CMake", 24, 0, 0, 5, 29
"/root/wqdServer/build/CMakeFiles/test_service_discovery.dir/cmake_clean.cmake", "CMake", 9, 0, 0, 2, 11
"/root/wqdServer/build/CMakeFiles/test_sqlite3.dir/DependInfo.cmake", "CMake", 24, 0, 0, 5, 29
"/root/wqdServer/build/CMakeFiles/test_sqlite3.dir/cmake_clean.cmake", "CMake", 9, 0, 0, 2, 11
"/root/wqdServer/build/CMakeFiles/test_util.dir/DependInfo.cmake", "CMake", 20, 0, 0, 4, 24
"/root/wqdServer/build/CMakeFiles/test_util.dir/cmake_clean.cmake", "CMake", 9, 0, 0, 2, 11
"/root/wqdServer/build/CMakeFiles/test_zkclient.dir/DependInfo.cmake", "CMake", 24, 0, 0, 5, 29
"/root/wqdServer/build/CMakeFiles/test_zkclient.dir/cmake_clean.cmake", "CMake", 9, 0, 0, 2, 11
"/root/wqdServer/build/cmake_install.cmake", "CMake", 42, 0, 0, 8, 50
"/root/wqdServer/cmake/FindMySQL.cmake", "CMake", 710, 0, 0, 129, 839
"/root/wqdServer/cmake/utils.cmake", "CMake", 57, 0, 0, 13, 70
"Total", "-", 1763, 434, 0, 416, 2613